__@@@@_@@
@_@@@@_@@
@_@@@@_@@
@__@@@_@@
@@_____@@
@@@@_@@@@