@_@@@@@@@@@@@@
@_@@@@______@@
@_@@@@_@@@@_@@
@_@@@@_@@@@_@@
@__@@@_@@@@_@@
@@_____@@@@_@@
@@@@_@@@@@@@@@
